year,İBBS3,city,population,total_cases,carried_over_from,opened_inside_year,finished,carried_over_to,returned,area
2021,TR100,İstanbul,15099946.0,2378387,1536743,841644,836525,1541862,12697,5461
2021,TR211,Tekirdağ,1105759.0,127163,59444,67719,62603,64560,516,6190
2021,TR212,Edirne,406215.0,50363,24888,25475,27064,23299,457,6145
2021,TR213,Kırklareli,363245.0,31716,12732,18984,18939,12777,215,6459
2021,TR221,Balıkesir,1238619.0,139589,66047,73542,74267,65322,913,14583
2021,TR222,Çanakkale,551237.0,59157,25710,33447,33954,25203,426,9817
2021,TR310,İzmir,4391056.0,611955,306414,305541,289353,322602,2738,11891
2021,TR321,Aydın,1121941.0,179808,92270,87538,85850,93958,977,8116
2021,TR322,Denizli,1035065.0,108234,48757,59477,61448,46786,496,12134
2021,TR323,Muğla,998594.0,146909,63779,83130,78778,68131,1012,12654
2021,TR331,Manisa,1447072.0,145620,69517,76103,75321,70299,903,13339
2021,TR332,Afyonkarahisar,731760.0,66428,27852,38576,37324,29104,347,14016
2021,TR333,Kütahya,566867.0,43732,17779,25953,24659,19073,222,11634
2021,TR334,Uşak,364712.0,41381,17389,23992,24024,17357,268,5555
2021,TR411,Bursa,3093542.0,368609,182428,186181,175307,193302,1070,10813
2021,TR412,Eskişehir,872007.0,116221,54113,62108,62989,53232,577,13960
2021,TR413,Bilecik,224818.0,24853,7943,16910,15139,9714,176,4179
2021,TR421,Kocaeli,2016057.0,194126,107497,86629,89200,104926,1577,3397
2021,TR422,Sakarya,1032790.0,94669,42687,51982,48369,46300,639,4824
2021,TR423,Düzce,393998.0,39639,19517,20122,18992,20647,236,2492
2021,TR424,Bolu,308937.0,30421,11083,19338,18883,11538,147,8313
2021,TR425,Yalova,259901.0,32364,11557,20807,19333,13031,323,798
2021,TR510,Ankara,5574061.0,809514,446593,362921,381335,428179,3023,25632
2021,TR521,Konya,2246531.0,233131,114670,118461,116530,116601,1581,40838
2021,TR522,Karaman,255637.0,25707,10560,15147,16032,9675,229,8678
2021,TR611,Antalya,2482886.0,375684,199950,175734,179397,196287,1824,20177
2021,TR612,Isparta,435515.0,43496,17064,26432,26905,16591,394,8946
2021,TR613,Burdur,268601.0,28572,12076,16496,17482,11090,238,7175
2021,TR621,Adana,2247474.0,245731,132916,112815,109810,135921,1485,13844
2021,TR622,Mersin,1851973.0,278329,152848,125481,116787,161542,1679,16010
2021,TR631,Hatay,1665619.0,174680,93380,81300,79516,95164,1347,5524
2021,TR632,Kahramanmaraş,1167038.0,94460,44209,50251,53210,41250,825,14520
2021,TR633,Osmaniye,552172.0,61150,25192,35958,37289,23861,493,3320
2021,TR711,Kırıkkale,267611.0,26882,11272,15610,14261,12621,180,4791
2021,TR712,Aksaray,411633.0,36623,17614,19009,17943,18680,163,7659
2021,TR713,Niğde,359113.0,33376,13733,19643,20182,13194,367,7234
2021,TR714,Nevşehir,298739.0,29757,11373,18384,18277,11480,198,5485
2021,TR715,Kırşehir,228939.0,17823,6234,11589,10981,6842,83,6584
2021,TR721,Kayseri,1413498.0,166472,79807,86665,79031,87441,1085,16970
2021,TR722,Sivas,628927.0,47202,16259,30943,30289,16913,345,28164
2021,TR723,Yozgat,407990.0,30527,12121,18406,17700,12827,250,13690
2021,TR811,Zonguldak,584753.0,43149,15895,27254,26262,16887,426,3342
2021,TR812,Karabük,238560.0,20808,7243,13565,13561,7247,139,4142
2021,TR813,Bartın,199505.0,16706,6483,10223,10309,6397,123,2330
2021,TR821,Kastamonu,370350.0,30401,11430,18971,18725,11676,203,13064
2021,TR822,Çankırı,190026.0,14294,5211,9083,9109,5185,160,7542
2021,TR823,Sinop,216094.0,15725,5084,10641,9895,5830,115,5717
2021,TR831,Samsun,1331362.0,130696,56847,73849,77505,53191,841,9725
2021,TR832,Tokat,595464.0,44244,17688,26556,29191,15053,446,10042
2021,TR833,Çorum,516327.0,47917,19541,28376,26336,21581,588,12428
2021,TR834,Amasya,331125.0,25542,9185,16357,16506,9036,160,5628
2021,TR901,Trabzon,802351.0,53259,20755,32504,31652,21607,606,4628
2021,TR902,Ordu,753106.0,53500,17916,35584,34654,18846,264,5914
2021,TR903,Giresun,444533.0,31991,11390,20601,19330,12661,326,6972
2021,TR904,Rize,343944.0,26341,10634,15707,15682,10659,273,3835
2021,TR905,Artvin,168939.0,14089,5584,8505,8165,5924,139,7393
2021,TR906,Gümüşhane,147898.0,9131,3381,5750,5825,3306,51,6668
2021,TRA11,Erzurum,751977.0,46470,19184,27286,26279,20191,222,25006
2021,TRA12,Erzincan,233631.0,18625,6589,12036,10852,7773,251,11815
2021,TRA13,Bayburt,84467.0,4813,1836,2977,2900,1913,37,3746
2021,TRA21,Ağrı,523527.0,40752,20595,20157,19335,21417,276,11099
2021,TRA22,Kars,279451.0,21018,7749,13269,14217,6801,189,10193
2021,TRA23,Iğdır,202205.0,20017,8918,11099,10648,9369,240,3664
2021,TRA24,Ardahan,94662.0,9149,3627,5522,5175,3974,40,4934
2021,TRB11,Malatya,803926.0,66264,25561,40703,38990,27274,320,12259
2021,TRB12,Elazığ,585652.0,45732,19855,25877,25310,20422,359,9383
2021,TRB13,Bingöl,282709.0,20860,9776,11084,11096,9764,73,8003
2021,TRB14,Tunceli,83279.0,12831,6136,6695,7190,5641,83,7582
2021,TRB21,Van,1136032.0,78934,40852,38082,37241,41693,529,20921
2021,TRB22,Muş,404772.0,25919,12558,13361,14468,11451,158,8718
2021,TRB23,Bitlis,352070.0,25423,12775,12648,13202,12221,182,8294
2021,TRB24,Hakkari,276871.0,27173,13771,13402,12744,14429,158,7095
2021,TRC11,Gaziantep,2112412.0,348570,221520,127050,114228,234342,1340,6803
2021,TRC12,Adıyaman,630523.0,37040,16868,20172,19355,17685,310,7337
2021,TRC13,Kilis,143817.0,20560,9514,11046,9915,10645,107,1412
2021,TRC21,Şanlıurfa,2132404.0,190046,89234,100812,99166,90880,1288,19242
2021,TRC22,Diyarbakır,1789716.0,229126,139715,89411,94095,135031,1244,15101
2021,TRC31,Mardin,859648.0,63275,27764,35511,35478,27797,564,8780
2021,TRC32,Batman,625072.0,56093,30809,25284,23335,32758,313,4477
2021,TRC33,Şırnak,545723.0,51729,28294,23435,24283,27446,464,7078
2021,TRC34,Siirt,331259.0,27970,12447,15523,16202,11768,190,5717
2020,TR100,İstanbul,15011868.0,2197808,1458710,739098,661068,1536740,8733,5461
2020,TR211,Tekirdağ,1074236.0,115139,57940,57199,55696,59443,453,6190
2020,TR212,Edirne,402237.0,48209,23490,24719,23321,24888,388,6145
2020,TR213,Kırklareli,359249.0,28844,11780,17064,16112,12732,110,6459
2020,TR221,Balıkesir,1229782.0,125662,63242,62420,59614,66048,746,14583
2020,TR222,Çanakkale,536513.0,52482,23774,28708,26772,25710,346,9817
2020,TR310,İzmir,4365022.0,543824,294752,249072,237411,306413,2370,11891
2020,TR321,Aydın,1108754.0,163357,85727,77630,71087,92270,893,8116
2020,TR322,Denizli,1028170.0,104271,46939,57332,55514,48757,378,12134
2020,TR323,Muğla,981159.0,128231,60246,67985,64451,63780,747,12654
2020,TR331,Manisa,1442166.0,130668,65891,64777,61151,69517,662,13339
2020,TR332,Afyonkarahisar,725813.0,61125,25191,35934,33273,27852,329,14016
2020,TR333,Kütahya,567438.0,42047,17909,24138,24268,17779,227,11634
2020,TR334,Uşak,361541.0,40109,17396,22713,22720,17389,371,5555
2020,TR411,Bursa,3057247.0,326944,170256,156688,144515,182429,886,10813
2020,TR412,Eskişehir,865311.0,110457,53812,56645,56344,54113,603,13960
2020,TR413,Bilecik,215480.0,21993,7461,14532,14049,7944,178,4179
2020,TR421,Kocaeli,1983504.0,184041,107517,76524,76544,107497,1188,3397
2020,TR422,Sakarya,1017864.0,88860,41616,47244,46172,42688,546,4824
2020,TR423,Düzce,389471.0,36973,19893,17080,17456,19517,215,2492
2020,TR424,Bolu,304628.0,28092,10493,17599,17009,11083,112,8313
2020,TR425,Yalova,253124.0,27385,11566,15819,15827,11558,282,798
2020,TR510,Ankara,5506786.0,722065,419365,302700,275473,446592,2366,25632
2020,TR521,Konya,2224384.0,215126,112139,102987,100454,114672,1120,40838
2020,TR522,Karaman,251791.0,24896,10542,14354,14336,10560,184,8678
2020,TR611,Antalya,2454014.0,356898,195412,161486,156948,199950,1373,20177
2020,TR612,Isparta,431143.0,42039,17206,24833,24976,17063,493,8946
2020,TR613,Burdur,262897.0,27916,12771,15145,15840,12076,326,7175
2020,TR621,Adana,2244748.0,230176,130984,99192,97261,132915,1178,13844
2020,TR622,Mersin,1839975.0,244320,141008,103312,91471,152849,1233,16010
2020,TR631,Hatay,1654907.0,158496,87778,70718,65115,93381,971,5524
2020,TR632,Kahramanmaraş,1164273.0,85947,41280,44667,41739,44208,542,14520
2020,TR633,Osmaniye,547923.0,51817,22375,29442,26625,25192,317,3320
2020,TR711,Kırıkkale,270486.0,23803,10263,13540,12532,11271,113,4791
2020,TR712,Aksaray,408201.0,34204,15992,18212,16590,17614,97,7659
2020,TR713,Niğde,358036.0,31696,11463,20233,17963,13733,265,7234
2020,TR714,Nevşehir,296226.0,28802,11361,17441,17428,11374,167,5485
2020,TR715,Kırşehir,229516.0,15388,4804,10584,9153,6235,80,6584
2020,TR721,Kayseri,1402941.0,139676,70506,69170,59869,79807,898,16970
2020,TR722,Sivas,629795.0,41860,14984,26876,25599,16261,219,28164
2020,TR723,Yozgat,409249.0,27200,11406,15794,15078,12122,126,13690
2020,TR811,Zonguldak,586358.0,41253,15877,25376,25358,15895,292,3342
2020,TR812,Karabük,234171.0,19195,7383,11812,11952,7243,89,4142
2020,TR813,Bartın,197422.0,13845,4673,9172,7362,6483,68,2330
2020,TR821,Kastamonu,370459.0,27044,10356,16688,15614,11430,149,13064
2020,TR822,Çankırı,186603.0,13741,5290,8451,8530,5211,161,7542
2020,TR823,Sinop,214076.0,13874,4530,9344,8790,5084,89,5717
2020,TR831,Samsun,1327875.0,121046,57997,63049,64198,56848,725,9725
2020,TR832,Tokat,591518.0,43127,18231,24896,25439,17688,240,10042
2020,TR833,Çorum,519193.0,41330,15415,25915,21790,19540,342,12428
2020,TR834,Amasya,331263.0,24825,8657,16168,15640,9185,78,5628
2020,TR901,Trabzon,799276.0,48505,20186,28319,27750,20755,398,4628
2020,TR902,Ordu,754282.0,50148,16826,33322,32231,17917,166,5914
2020,TR903,Giresun,443544.0,28392,10648,17744,17003,11389,241,6972
2020,TR904,Rize,342769.0,23988,9916,14072,13354,10634,137,3835
2020,TR905,Artvin,168860.0,13727,5690,8037,8143,5584,196,7393
2020,TR906,Gümüşhane,139712.0,7870,2705,5165,4489,3381,31,6668
2020,TRA11,Erzurum,753742.0,45336,20865,24471,26152,19184,218,25006
2020,TRA12,Erzincan,231126.0,16230,6306,9924,9641,6589,178,11815
2020,TRA13,Bayburt,81372.0,4249,1742,2507,2413,1836,31,3746
2020,TRA21,Ağrı,534586.0,40362,22509,17853,19767,20595,343,11099
2020,TRA22,Kars,283159.0,18691,6559,12132,10942,7749,127,10193
2020,TRA23,Iğdır,200635.0,17114,7990,9124,8196,8918,181,3664
2020,TRA24,Ardahan,95920.0,8266,3406,4860,4639,3627,38,4934
2020,TRB11,Malatya,801767.0,64356,28101,36255,38795,25561,282,12259
2020,TRB12,Elazığ,585450.0,41740,20007,21733,21885,19855,297,9383
2020,TRB13,Bingöl,281433.0,18885,9035,9850,9109,9776,72,8003
2020,TRB14,Tunceli,83157.0,11628,5799,5829,5492,6136,69,7582
2020,TRB21,Van,1145279.0,75523,41267,34256,34670,40853,508,20921
2020,TRB22,Muş,410692.0,25840,13165,12675,13282,12558,207,8718
2020,TRB23,Bitlis,350663.0,23277,12108,11169,10503,12774,150,8294
2020,TRB24,Hakkari,279858.0,24571,13266,11305,10800,13771,140,7095
2020,TRC11,Gaziantep,2085795.0,311024,199331,111693,89504,221520,1308,6803
2020,TRC12,Adıyaman,631039.0,34792,16180,18612,17924,16868,149,7337
2020,TRC13,Kilis,141454.0,18356,9895,8461,8842,9514,94,1412
2020,TRC21,Şanlıurfa,2108013.0,163495,90053,73442,74261,89234,839,19242
2020,TRC22,Diyarbakır,1782256.0,215653,129813,85840,75938,139715,996,15101
2020,TRC31,Mardin,851922.0,55788,24563,31225,28023,27765,393,8780
2020,TRC32,Batman,619021.0,52317,29387,22930,21508,30809,521,4477
2020,TRC33,Şırnak,536990.0,44182,24669,19513,15887,28295,403,7078
2020,TRC34,Siirt,330374.0,22710,11026,11684,10263,12447,132,5717
2019,TR100,İstanbul,14921827.0,2243323,1442784,800539,784618,1458705,10726,5461
2019,TR211,Tekirdağ,1048506.0,129296,62444,66852,71356,57940,542,6190
2019,TR212,Edirne,408482.0,51183,24171,27012,27693,23490,388,6145
2019,TR213,Kırklareli,358941.0,31793,13018,18775,20013,11780,125,6459
2019,TR221,Balıkesir,1217757.0,133056,66213,66843,69815,63241,1020,14583
2019,TR222,Çanakkale,535060.0,56031,23604,32427,32257,23774,354,9817
2019,TR310,İzmir,4333920.0,549943,295200,254743,255192,294751,2777,11891
2019,TR321,Aydın,1100545.0,167058,83601,83457,81331,85727,822,8116
2019,TR322,Denizli,1023955.0,107162,47618,59544,60223,46939,548,12134
2019,TR323,Muğla,962878.0,138881,62485,76396,78636,60245,1140,12654
2019,TR331,Manisa,1431583.0,142702,71958,70744,76811,65891,702,13339
2019,TR332,Afyonkarahisar,718986.0,60935,24417,36518,35745,25190,311,14016
2019,TR333,Kütahya,569683.0,45623,20077,25546,27714,17909,351,11634
2019,TR334,Uşak,362193.0,39438,17736,21702,22042,17396,582,5555
2019,TR411,Bursa,3007525.0,334885,169880,165005,164631,170254,1338,10813
2019,TR412,Eskişehir,863273.0,116713,54026,62687,62901,53812,483,13960
2019,TR413,Bilecik,215947.0,21971,7600,14371,14510,7461,142,4179
2019,TR421,Kocaeli,1940551.0,198489,113986,84503,90971,107518,1353,3397
2019,TR422,Sakarya,1005485.0,98349,43846,54503,56733,41616,595,4824
2019,TR423,Düzce,385831.0,39172,20616,18556,19279,19893,119,2492
2019,TR424,Bolu,305475.0,26757,9884,16873,16265,10492,266,8313
2019,TR425,Yalova,247064.0,29691,12155,17536,18125,11566,352,798
2019,TR510,Ankara,5464164.0,736639,432454,304185,317273,419366,2841,25632
2019,TR521,Konya,2209911.0,219862,111068,108794,107723,112139,1374,40838
2019,TR522,Karaman,250348.0,26985,12291,14694,16443,10542,206,8678
2019,TR611,Antalya,2409057.0,390246,207239,183007,194833,195413,1808,20177
2019,TR612,Isparta,435922.0,44022,17377,26645,26816,17206,501,8946
2019,TR613,Burdur,266696.0,28203,12181,16022,15432,12771,184,7175
2019,TR621,Adana,2223904.0,241380,139198,102182,110396,130984,1463,13844
2019,TR622,Mersin,1810696.0,252490,143471,109019,111484,141006,1775,16010
2019,TR631,Hatay,1624417.0,157419,84768,72651,69641,87778,992,5524
2019,TR632,Kahramanmaraş,1149978.0,87198,41664,45534,45919,41279,514,14520
2019,TR633,Osmaniye,538125.0,51021,21677,29344,28646,22375,329,3320
2019,TR711,Kırıkkale,275007.0,24549,9654,14895,14286,10263,192,4791
2019,TR712,Aksaray,402095.0,36588,18398,18190,20596,15992,137,7659
2019,TR713,Niğde,358973.0,28985,11261,17724,17522,11463,247,7234
2019,TR714,Nevşehir,294434.0,32243,13586,18657,20882,11361,235,5485
2019,TR715,Kırşehir,229757.0,17150,5605,11545,12347,4803,82,6584
2019,TR721,Kayseri,1388760.0,141109,65805,75304,70603,70506,888,16970
2019,TR722,Sivas,632799.0,43949,15328,28621,28965,14984,170,28164
2019,TR723,Yozgat,411665.0,29349,10295,19054,17943,11406,183,13690
2019,TR811,Zonguldak,590611.0,47317,16789,30528,31440,15877,360,3342
2019,TR812,Karabük,239098.0,19599,6793,12806,12216,7383,135,4142
2019,TR813,Bartın,196980.0,15976,5993,9983,11303,4673,108,2330
2019,TR821,Kastamonu,372620.0,28237,11335,16902,17881,10356,219,13064
2019,TR822,Çankırı,189748.0,14235,5219,9016,8945,5290,182,7542
2019,TR823,Sinop,215773.0,14550,4422,10128,10020,4530,114,5717
2019,TR831,Samsun,1315579.0,130238,60967,69271,72241,57997,747,9725
2019,TR832,Tokat,606950.0,49150,20979,28171,30919,18231,307,10042
2019,TR833,Çorum,518749.0,41129,15101,26028,25714,15415,427,12428
2019,TR834,Amasya,333411.0,25829,8768,17061,17172,8657,105,5628
2019,TR901,Trabzon,796379.0,52131,21316,30815,31945,20186,330,4628
2019,TR902,Ordu,746699.0,50906,16927,33979,34080,16826,205,5914
2019,TR903,Giresun,442924.0,33263,12966,20297,22616,10647,352,6972
2019,TR904,Rize,341627.0,25565,10067,15498,15649,9916,144,3835
2019,TR905,Artvin,170197.0,16271,6555,9716,10581,5690,279,7393
2019,TR906,Gümüşhane,162507.0,8312,2536,5776,5607,2705,37,6668
2019,TRA11,Erzurum,757521.0,51062,23752,27310,30197,20865,278,25006
2019,TRA12,Erzincan,231414.0,19227,7825,11402,12921,6306,241,11815
2019,TRA13,Bayburt,84280.0,4969,2369,2600,3227,1742,25,3746
2019,TRA21,Ağrı,535355.0,41322,20049,21273,18813,22509,295,11099
2019,TRA22,Kars,283365.0,21271,7915,13356,14712,6559,194,10193
2019,TRA23,Iğdır,198640.0,17117,7905,9212,9129,7988,204,3664
2019,TRA24,Ardahan,97016.0,9328,4097,5231,5923,3405,57,4934
2019,TRB11,Malatya,795785.0,64035,27473,36562,35934,28101,351,12259
2019,TRB12,Elazığ,587839.0,43317,20036,23281,23310,20007,267,9383
2019,TRB13,Bingöl,279491.0,19603,9500,10103,10568,9035,83,8003
2019,TRB14,Tunceli,84425.0,12154,6157,5997,6355,5799,114,7582
2019,TRB21,Van,1132328.0,83204,43107,40097,41937,41267,775,20921
2019,TRB22,Muş,408389.0,27681,12745,14936,14516,13165,194,8718
2019,TRB23,Bitlis,347889.0,25446,13379,12067,13338,12108,194,8294
2019,TRB24,Hakkari,279908.0,26933,14132,12801,13667,13266,264,7095
2019,TRC11,Gaziantep,2051268.0,304822,191319,113503,105491,199331,1858,6803
2019,TRC12,Adıyaman,624890.0,37162,16604,20558,20982,16180,172,7337
2019,TRC13,Kilis,141186.0,18411,10452,7959,8516,9895,98,1412
2019,TRC21,Şanlıurfa,2064026.0,176238,88061,88177,86185,90053,875,19242
2019,TRC22,Diyarbakır,1755220.0,225199,127070,98129,95387,129812,1173,15101
2019,TRC31,Mardin,835964.0,60854,26519,34335,36289,24565,497,8780
2019,TRC32,Batman,607358.0,57358,31674,25684,27971,29387,840,4477
2019,TRC33,Şırnak,528701.0,46462,24224,22238,21792,24670,485,7078
2019,TRC34,Siirt,329532.0,24955,11976,12979,13930,11025,164,5717
2018,TR100,İstanbul,14635481.0,2191510,1380881,810629,748747,1442763,7991,5461
2018,TR211,Tekirdağ,1025422.0,119112,55354,63758,56669,62443,480,6190
2018,TR212,Edirne,408594.0,49969,22536,27433,25798,24171,240,6145
2018,TR213,Kırklareli,358648.0,32142,13314,18828,19124,13018,134,6459
2018,TR221,Balıkesir,1217183.0,134478,65247,69231,68266,66212,752,14583
2018,TR222,Çanakkale,534374.0,53117,22733,30384,29513,23604,236,9817
2018,TR310,İzmir,4291497.0,540161,277240,262921,244963,295198,2231,11891
2018,TR321,Aydın,1089215.0,161311,79206,82105,77710,83601,873,8116
2018,TR322,Denizli,1018240.0,109592,48624,60968,61974,47618,542,12134
2018,TR323,Muğla,950131.0,128080,56640,71440,65595,62485,658,12654
2018,TR331,Manisa,1421167.0,145556,69620,75936,73597,71959,486,13339
2018,TR332,Afyonkarahisar,716388.0,60964,24090,36874,36547,24417,278,14016
2018,TR333,Kütahya,568192.0,45825,20162,25663,25748,20077,299,11634
2018,TR334,Uşak,359437.0,35617,15116,20501,17881,17736,345,5555
2018,TR411,Bursa,2949723.0,325335,162776,162559,155452,169883,924,10813
2018,TR412,Eskişehir,852411.0,111540,53667,57873,57514,54026,315,13960
2018,TR413,Bilecik,219755.0,22557,6947,15610,14957,7600,140,4179
2018,TR421,Kocaeli,1897152.0,194426,106493,87933,80441,113985,801,3397
2018,TR422,Sakarya,989653.0,99171,41133,58038,55325,43846,507,4824
2018,TR423,Düzce,381909.0,39413,19400,20013,18797,20616,167,2492
2018,TR424,Bolu,303821.0,25167,9624,15543,15283,9884,162,8313
2018,TR425,Yalova,243677.0,27016,11542,15474,14861,12155,287,798
2018,TR510,Ankara,5365747.0,765399,432636,332763,332946,432453,2295,25632
2018,TR521,Konya,2187065.0,214114,100682,113432,103046,111068,1003,40838
2018,TR522,Karaman,248750.0,25055,10231,14824,12764,12291,89,8678
2018,TR611,Antalya,2350534.0,395081,210205,184876,187844,207237,1692,20177
2018,TR612,Isparta,434410.0,44646,18397,26249,27269,17377,338,8946
2018,TR613,Burdur,266500.0,27780,12079,15701,15599,12181,178,7175
2018,TR621,Adana,2208316.0,242187,131835,110352,102989,139198,996,13844
2018,TR622,Mersin,1792762.0,246467,136875,109592,102996,143471,1163,16010
2018,TR631,Hatay,1605852.0,155705,80598,75107,70938,84767,1015,5524
2018,TR632,Kahramanmaraş,1140139.0,86153,36338,49815,44489,41664,482,14520
2018,TR633,Osmaniye,533913.0,46277,18156,28121,24599,21678,176,3320
2018,TR711,Kırıkkale,279317.0,25637,9668,15969,15984,9653,210,4791
2018,TR712,Aksaray,398744.0,38248,18210,20038,19850,18398,239,7659
2018,TR713,Niğde,361596.0,31284,12320,18964,20023,11261,169,7234
2018,TR714,Nevşehir,291409.0,30772,11641,19131,17186,13586,169,5485
2018,TR715,Kırşehir,230939.0,17166,5822,11344,11561,5605,77,6584
2018,TR721,Kayseri,1374093.0,135364,57510,77854,69559,65805,699,16970
2018,TR722,Sivas,641170.0,46035,15710,30325,30706,15329,273,28164
2018,TR723,Yozgat,415677.0,30849,11486,19363,20553,10296,234,13690
2018,TR811,Zonguldak,594694.0,49617,18010,31607,32828,16789,330,3342
2018,TR812,Karabük,240595.0,20613,6859,13754,13820,6793,133,4142
2018,TR813,Bartın,197996.0,16645,6269,10376,10652,5993,42,2330
2018,TR821,Kastamonu,377208.0,29560,11063,18497,18225,11335,99,13064
2018,TR822,Çankırı,210958.0,13961,5448,8513,8742,5219,104,7542
2018,TR823,Sinop,217605.0,14676,4490,10186,10254,4422,159,5717
2018,TR831,Samsun,1306536.0,127216,56531,70685,66249,60967,601,9725
2018,TR832,Tokat,607135.0,48520,18710,29810,27541,20979,211,10042
2018,TR833,Çorum,523178.0,39983,14660,25323,24883,15100,282,12428
2018,TR834,Amasya,333211.0,25484,9557,15927,16716,8768,63,5628
2018,TR901,Trabzon,798147.0,55084,21087,33997,33769,21315,311,4628
2018,TR902,Ordu,764696.0,53541,19309,34232,36614,16927,206,5914
2018,TR903,Giresun,448886.0,34145,12165,21980,21179,12966,241,6972
2018,TR904,Rize,347271.0,23811,8117,15694,13744,10067,61,3835
2018,TR905,Artvin,173360.0,16107,6518,9589,9553,6554,122,7393
2018,TR906,Gümüşhane,160861.0,9331,2712,6619,6795,2536,32,6668
2018,TRA11,Erzurum,763687.0,59337,26099,33238,35584,23753,416,25006
2018,TRA12,Erzincan,232795.0,21026,8712,12314,13201,7825,219,11815
2018,TRA13,Bayburt,81714.0,5863,2202,3661,3494,2369,8,3746
2018,TRA21,Ağrı,538903.0,43560,20096,23464,23513,20047,245,11099
2018,TRA22,Kars,287392.0,22454,8370,14084,14539,7915,147,10193
2018,TRA23,Iğdır,196777.0,17943,8454,9489,10038,7905,157,3664
2018,TRA24,Ardahan,98543.0,10004,4439,5565,5907,4097,24,4934
2018,TRB11,Malatya,793202.0,63535,26107,37428,36062,27473,244,12259
2018,TRB12,Elazığ,592756.0,48325,19519,28806,28289,20036,232,9383
2018,TRB13,Bingöl,280935.0,19812,9134,10678,10312,9500,119,8003
2018,TRB14,Tunceli,88011.0,12386,5798,6588,6229,6157,108,7582
2018,TRB21,Van,1120416.0,79903,39196,40707,36796,43107,501,20921
2018,TRB22,Muş,407594.0,24138,11957,12181,11393,12745,161,8718
2018,TRB23,Bitlis,349204.0,26904,12676,14228,13525,13379,194,8294
2018,TRB24,Hakkari,285930.0,27803,14209,13594,13671,14132,146,7095
2018,TRC11,Gaziantep,2012566.0,288040,171423,116617,96719,191321,1575,6803
2018,TRC12,Adıyaman,623008.0,36289,15519,20770,19685,16604,131,7337
2018,TRC13,Kilis,141623.0,18241,10110,8131,7789,10452,64,1412
2018,TRC21,Şanlıurfa,2026597.0,164101,82072,82029,76039,88062,912,19242
2018,TRC22,Diyarbakır,1731520.0,223692,122518,101174,96621,127071,1397,15101
2018,TRC31,Mardin,826039.0,64708,24759,39949,38189,26519,563,8780
2018,TRC32,Batman,598011.0,62354,35568,26786,30680,31674,454,4477
2018,TRC33,Şırnak,523445.0,51100,25830,25270,26876,24224,340,7078
2018,TRC34,Siirt,330840.0,26118,13289,12829,14142,11976,194,5717
2017,TR100,İstanbul,14701360.0,2014392,1260971,753421,633517,1380875,7396,5461
2017,TR211,Tekirdağ,1001879.0,99850,41577,58273,44496,55354,436,6190
2017,TR212,Edirne,404492.0,45599,18816,26783,23062,22537,233,6145
2017,TR213,Kırklareli,354493.0,29393,10871,18522,16079,13314,149,6459
2017,TR221,Balıkesir,1197045.0,124121,55200,68921,58874,65247,619,14583
2017,TR222,Çanakkale,525865.0,48680,18997,29683,25947,22733,280,9817
2017,TR310,İzmir,4253602.0,488195,245722,242473,210961,277234,1912,11891
2017,TR321,Aydın,1073522.0,149776,68420,81356,70570,79206,733,8116
2017,TR322,Denizli,1010932.0,106883,49633,57250,58259,48624,468,12134
2017,TR323,Muğla,923556.0,118271,48833,69438,61632,56639,736,12654
2017,TR331,Manisa,1405864.0,133442,61652,71790,63822,69620,642,13339
2017,TR332,Afyonkarahisar,708627.0,58690,20592,38098,34597,24093,243,14016
2017,TR333,Kütahya,563769.0,39476,14440,25036,19314,20162,140,11634
2017,TR334,Uşak,356562.0,31883,12940,18943,16767,15116,271,5555
2017,TR411,Bursa,2910605.0,300965,142762,158203,138191,162774,787,10813
2017,TR412,Eskişehir,846667.0,103069,52548,50521,49402,53667,335,13960
2017,TR413,Bilecik,218514.0,21971,6737,15234,15024,6947,198,4179
2017,TR421,Kocaeli,1875332.0,175942,95516,80426,69449,106493,747,3397
2017,TR422,Sakarya,974628.0,89053,35487,53566,47920,41133,441,4824
2017,TR423,Düzce,373616.0,34317,15034,19283,14917,19400,137,2492
2017,TR424,Bolu,298260.0,24596,9269,15327,14972,9624,105,8313
2017,TR425,Yalova,238043.0,23188,9325,13863,11646,11542,192,798
2017,TR510,Ankara,5360554.0,693886,383790,310096,261250,432636,1871,25632
2017,TR521,Konya,2165192.0,200174,89577,110597,99492,100682,1116,40838
2017,TR522,Karaman,244089.0,21046,7362,13684,10815,10231,51,8678
2017,TR611,Antalya,2306973.0,347773,179612,168161,137569,210204,1247,20177
2017,TR612,Isparta,428378.0,42250,14823,27427,23853,18397,320,8946
2017,TR613,Burdur,262958.0,26092,9998,16094,14013,12079,136,7175
2017,TR621,Adana,2207079.0,237840,123504,114336,106004,131836,1193,13844
2017,TR622,Mersin,1776547.0,233871,123814,110057,96997,136874,1126,16010
2017,TR631,Hatay,1571426.0,144529,71004,73525,63931,80598,789,5524
2017,TR632,Kahramanmaraş,1120694.0,76437,29827,46610,40099,36338,516,14520
2017,TR633,Osmaniye,527174.0,40966,14047,26919,22811,18155,219,3320
2017,TR711,Kırıkkale,272262.0,24297,8261,16036,14629,9668,267,4791
2017,TR712,Aksaray,391924.0,36786,16958,19828,18576,18210,189,7659
2017,TR713,Niğde,350421.0,31842,10214,21628,19522,12320,119,7234
2017,TR714,Nevşehir,288151.0,27417,9751,17666,15777,11640,172,5485
2017,TR715,Kırşehir,225700.0,16940,5663,11277,11118,5822,24,6584
2017,TR721,Kayseri,1366684.0,121518,47614,73904,64008,57510,488,16970
2017,TR722,Sivas,616511.0,44134,14535,29599,28424,15710,162,28164
2017,TR723,Yozgat,410405.0,31669,11249,20420,20184,11485,154,13690
2017,TR811,Zonguldak,592416.0,43471,14529,28942,25462,18009,274,3342
2017,TR812,Karabük,238058.0,20625,6584,14041,13766,6859,173,4142
2017,TR813,Bartın,192711.0,15835,4958,10877,9566,6269,54,2330
2017,TR821,Kastamonu,367470.0,25340,9782,15558,14277,11063,116,13064
2017,TR822,Çankırı,181429.0,13112,4371,8741,7664,5448,89,7542
2017,TR823,Sinop,205305.0,13869,3444,10425,9379,4490,123,5717
2017,TR831,Samsun,1292069.0,118065,49116,68949,61534,56531,604,9725
2017,TR832,Tokat,596841.0,45009,15948,29061,26301,18708,182,10042
2017,TR833,Çorum,516468.0,35687,11973,23714,21027,14660,187,12428
2017,TR834,Amasya,327079.0,24400,7840,16560,14843,9557,65,5628
2017,TR901,Trabzon,778696.0,49266,19243,30023,28180,21086,201,4628
2017,TR902,Ordu,736155.0,51594,17840,33754,32285,19309,228,5914
2017,TR903,Giresun,432965.0,31191,9868,21323,19026,12165,194,6972
2017,TR904,Rize,329810.0,21662,7335,14327,13546,8116,57,3835
2017,TR905,Artvin,165622.0,13524,5150,8374,7006,6518,104,7393
2017,TR906,Gümüşhane,168340.0,8888,2371,6517,6176,2712,44,6668
2017,TRA11,Erzurum,757258.0,59525,22490,37035,33426,26099,344,25006
2017,TRA12,Erzincan,227964.0,19386,7563,11823,10674,8712,147,11815
2017,TRA13,Bayburt,80030.0,5476,1701,3775,3274,2202,21,3746
2017,TRA21,Ağrı,535577.0,38376,16555,21821,18280,20096,187,11099
2017,TRA22,Kars,286485.0,19962,6573,13389,11592,8370,167,10193
2017,TRA23,Iğdır,194211.0,16485,6504,9981,8032,8453,115,3664
2017,TRA24,Ardahan,96719.0,9409,3639,5770,4971,4438,29,4934
2017,TRB11,Malatya,783348.0,59105,22557,36548,32998,26107,273,12259
2017,TRB12,Elazığ,581170.0,46067,18060,28007,26548,19519,217,9383
2017,TRB13,Bingöl,273043.0,19259,8377,10882,10124,9135,80,8003
2017,TRB14,Tunceli,82334.0,11284,4600,6684,5486,5798,41,7582
2017,TRB21,Van,1104347.0,76145,37351,38794,36949,39196,568,20921
2017,TRB22,Muş,404165.0,22727,10528,12199,10771,11956,106,8718
2017,TRB23,Bitlis,341324.0,25405,10540,14865,12729,12676,151,8294
2017,TRB24,Hakkari,275405.0,26949,12709,14240,12740,14209,160,7095
2017,TRC11,Gaziantep,1990463.0,247830,129749,118081,76407,171423,1383,6803
2017,TRC12,Adıyaman,614016.0,34745,14721,20024,19226,15519,169,7337
2017,TRC13,Kilis,135487.0,16839,8344,8495,6729,10110,79,1412
2017,TRC21,Şanlıurfa,1978855.0,146888,73059,73829,64818,82070,800,19242
2017,TRC22,Diyarbakır,1699100.0,196953,111289,85664,74436,122517,1185,15101
2017,TRC31,Mardin,807390.0,55241,21803,33438,30482,24759,598,8780
2017,TRC32,Batman,584487.0,59437,26791,32646,23869,35568,206,4477
2017,TRC33,Şırnak,502592.0,49261,23572,25689,23432,25829,145,7078
2017,TRC34,Siirt,323905.0,24044,10352,13692,10755,13289,76,5717
2016,TR100,İstanbul,14556739.0,1848675,1210957,637718,587688,1260987,5973,5461
2016,TR211,Tekirdağ,969128.0,81916,34103,47813,40339,41577,385,6190
2016,TR212,Edirne,398840.0,39054,16468,22586,20238,18816,107,6145
2016,TR213,Kırklareli,350244.0,23303,7226,16077,12432,10871,104,6459
2016,TR221,Balıkesir,1188307.0,102670,42994,59676,47470,55200,367,14583
2016,TR222,Çanakkale,515339.0,41739,16061,25678,22742,18997,250,9817
2016,TR310,İzmir,4196228.0,439205,230328,208877,193481,245724,1844,11891
2016,TR321,Aydın,1060046.0,125825,58420,67405,57403,68422,639,8116
2016,TR322,Denizli,997835.0,96287,45884,50403,46654,49633,241,12134
2016,TR323,Muğla,906553.0,109486,46453,63033,60653,48833,772,12654
2016,TR331,Manisa,1391158.0,117655,54598,63057,56003,61652,364,13339
2016,TR332,Afyonkarahisar,707997.0,46792,16205,30587,26200,20592,160,14016
2016,TR333,Kütahya,566610.0,33258,9763,23495,18818,14440,90,11634
2016,TR334,Uşak,351194.0,29317,11638,17679,16377,12940,191,5555
2016,TR411,Bursa,2863866.0,264839,121583,143256,122077,142762,629,10813
2016,TR412,Eskişehir,833283.0,98116,50012,48104,45568,52548,365,13960
2016,TR413,Bilecik,214834.0,17899,5086,12813,11162,6737,56,4179
2016,TR421,Kocaeli,1823015.0,153412,85639,67773,57895,95517,651,3397
2016,TR422,Sakarya,957760.0,77179,29095,48084,41692,35487,277,4824
2016,TR423,Düzce,366744.0,29174,10560,18614,14140,15034,119,2492
2016,TR424,Bolu,295345.0,23264,7861,15403,13995,9269,74,8313
2016,TR425,Yalova,230538.0,18521,7494,11027,9196,9325,158,798
2016,TR510,Ankara,5276144.0,625597,350204,275393,241808,383789,1349,25632
2016,TR521,Konya,2145186.0,174956,74334,100622,85379,89577,882,40838
2016,TR522,Karaman,243348.0,17555,4795,12760,10193,7362,52,8678
2016,TR611,Antalya,2268021.0,314051,158781,155270,134439,179612,995,20177
2016,TR612,Isparta,421690.0,34887,11033,23854,20064,14823,194,8946
2016,TR613,Burdur,259009.0,21163,6842,14321,11165,9998,51,7175
2016,TR621,Adana,2192471.0,218678,110877,107801,95175,123503,881,13844
2016,TR622,Mersin,1755996.0,202522,104208,98314,78709,123813,670,16010
2016,TR631,Hatay,1550650.0,126984,59328,67656,55980,71004,728,5524
2016,TR632,Kahramanmaraş,1109579.0,63159,25677,37482,33332,29827,407,14520
2016,TR633,Osmaniye,521561.0,35169,10087,25082,21122,14047,152,3320
2016,TR711,Kırıkkale,272012.0,20801,7027,13774,12540,8261,165,4791
2016,TR712,Aksaray,387491.0,27727,10197,17530,10769,16958,84,7659
2016,TR713,Niğde,348936.0,22981,6200,16781,12767,10214,72,7234
2016,TR714,Nevşehir,287626.0,23073,7302,15771,13322,9751,127,5485
2016,TR715,Kırşehir,225252.0,14200,3851,10349,8537,5663,27,6584
2016,TR721,Kayseri,1347629.0,106448,39556,66892,58834,47614,360,16970
2016,TR722,Sivas,617012.0,36768,11802,24966,22233,14535,163,28164
2016,TR723,Yozgat,413883.0,24787,6420,18367,13538,11249,105,13690
2016,TR811,Zonguldak,593718.0,36869,10596,26273,22340,14529,135,3342
2016,TR812,Karabük,237620.0,17892,4526,13366,11308,6584,79,4142
2016,TR813,Bartın,191585.0,12728,3324,9404,7770,4958,45,2330
2016,TR821,Kastamonu,371699.0,22775,6438,16337,12993,9782,62,13064
2016,TR822,Çankırı,179601.0,12031,3191,8840,7660,4371,53,7542
2016,TR823,Sinop,203508.0,12737,2290,10447,9293,3444,56,5717
2016,TR831,Samsun,1281286.0,101246,40786,60460,52130,49116,340,9725
2016,TR832,Tokat,597994.0,33833,9706,24127,17885,15948,85,10042
2016,TR833,Çorum,518538.0,29487,8674,20813,17514,11973,144,12428
2016,TR834,Amasya,323565.0,19845,5809,14036,12008,7837,56,5628
2016,TR901,Trabzon,773058.0,44801,15967,28834,25558,19243,199,4628
2016,TR902,Ordu,745766.0,42723,11623,31100,24883,17840,151,5914
2016,TR903,Giresun,441115.0,26727,7430,19297,16859,9868,126,6972
2016,TR904,Rize,329867.0,18664,5633,13031,11329,7335,107,3835
2016,TR905,Artvin,167598.0,11308,3781,7527,6158,5150,73,7393
2016,TR906,Gümüşhane,170298.0,7251,1641,5610,4880,2371,49,6668
2016,TRA11,Erzurum,758682.0,44168,17284,26884,21677,22491,244,25006
2016,TRA12,Erzincan,222610.0,16116,5466,10650,8553,7563,46,11815
2016,TRA13,Bayburt,89722.0,4254,929,3325,2553,1701,16,3746
2016,TRA21,Ağrı,541520.0,30174,12522,17652,13619,16555,153,11099
2016,TRA22,Kars,288569.0,14318,4579,9739,7745,6573,46,10193
2016,TRA23,Iğdır,192137.0,13111,4672,8439,6607,6504,80,3664
2016,TRA24,Ardahan,97922.0,7107,2304,4803,3467,3640,10,4934
2016,TRB11,Malatya,777109.0,53225,20887,32338,30668,22557,243,12259
2016,TRB12,Elazığ,576891.0,40155,15571,24584,22095,18060,206,9383
2016,TRB13,Bingöl,269029.0,15863,6666,9197,7486,8377,76,8003
2016,TRB14,Tunceli,82053.0,7945,3325,4620,3345,4600,34,7582
2016,TRB21,Van,1097762.0,57717,29114,28603,20366,37351,273,20921
2016,TRB22,Muş,406135.0,17434,7315,10119,6906,10528,43,8718
2016,TRB23,Bitlis,340845.0,19579,7473,12106,9039,10540,75,8294
2016,TRB24,Hakkari,267586.0,18643,9131,9512,5934,12709,79,7095
2016,TRC11,Gaziantep,1955922.0,195690,94764,100926,65944,129746,765,6803
2016,TRC12,Adıyaman,609826.0,29493,11028,18465,14771,14722,79,7337
2016,TRC13,Kilis,130290.0,15025,7103,7922,6681,8344,55,1412
2016,TRC21,Şanlıurfa,1935283.0,119507,56301,63206,46448,73059,516,19242
2016,TRC22,Diyarbakır,1672082.0,155495,95408,60087,44200,111295,497,15101
2016,TRC31,Mardin,794070.0,43140,16891,26249,21337,21803,421,8780
2016,TRC32,Batman,575241.0,45760,21234,24526,18969,26791,245,4477
2016,TRC33,Şırnak,483125.0,37391,15428,21963,13819,23572,104,7078
2016,TRC34,Siirt,322135.0,17297,8183,9114,6945,10352,58,5717
2015,TR100,İstanbul,14458174.0,1858130,1216169,641961,647173,1210957,5907,5461
2015,TR211,Tekirdağ,934568.0,79826,33071,46755,45723,34103,356,6190
2015,TR212,Edirne,399784.0,37897,15629,22268,21429,16468,161,6145
2015,TR213,Kırklareli,345744.0,23504,7580,15924,16278,7226,174,6459
2015,TR221,Balıkesir,1180416.0,99862,41315,58547,56868,42994,442,14583
2015,TR222,Çanakkale,510837.0,41257,15649,25608,25196,16061,309,9817
2015,TR310,İzmir,4143818.0,435150,231919,203231,204823,230327,1534,11891
2015,TR321,Aydın,1045492.0,119636,56355,63281,61216,58420,804,8116
2015,TR322,Denizli,986622.0,95154,45962,49192,49270,45884,311,12134
2015,TR323,Muğla,892323.0,104377,46237,58140,57924,46453,614,12654
2015,TR331,Manisa,1376228.0,115989,54554,61435,61391,54598,471,13339
2015,TR332,Afyonkarahisar,704520.0,46159,16192,29967,29956,16203,158,14016
2015,TR333,Kütahya,566846.0,32467,9888,22579,22704,9763,166,11634
2015,TR334,Uşak,347757.0,30056,12161,17895,18418,11638,231,5555
2015,TR411,Bursa,2813650.0,251028,117326,133702,129448,121580,549,10813
2015,TR412,Eskişehir,817865.0,93328,47011,46317,43316,50012,378,13960
2015,TR413,Bilecik,210051.0,16870,5375,11495,11785,5085,55,4179
2015,TR421,Kocaeli,1773047.0,154391,86388,68003,68752,85639,678,3397
2015,TR422,Sakarya,941667.0,72524,27156,45368,43429,29095,204,4824
2015,TR423,Düzce,358404.0,27927,10312,17615,17366,10561,120,2492
2015,TR424,Bolu,287328.0,22746,7372,15374,14885,7861,72,8313
2015,TR425,Yalova,226225.0,17874,6700,11174,10380,7494,194,798
2015,TR510,Ankara,5215511.0,609916,344437,265479,259712,350204,995,25632
2015,TR521,Konya,2116731.0,170446,67458,102988,96113,74333,764,40838
2015,TR522,Karaman,240810.0,17858,4986,12872,13063,4795,39,8678
2015,TR611,Antalya,2233701.0,305599,154485,151114,146818,158781,1005,20177
2015,TR612,Isparta,416816.0,32707,10865,21842,21674,11033,160,8946
2015,TR613,Burdur,256380.0,20115,6665,13450,13273,6842,22,7175
2015,TR621,Adana,2173795.0,211659,109439,102220,100783,110876,838,13844
2015,TR622,Mersin,1733477.0,191698,96660,95038,87490,104208,720,16010
2015,TR631,Hatay,1529511.0,121512,55675,65837,62184,59328,692,5524
2015,TR632,Kahramanmaraş,1093600.0,64363,26713,37650,38687,25676,389,14520
2015,TR633,Osmaniye,512359.0,35397,11961,23436,25310,10087,168,3320
2015,TR711,Kırıkkale,267176.0,20279,6779,13500,13252,7027,94,4791
2015,TR712,Aksaray,379545.0,27538,10113,17425,17341,10197,153,7659
2015,TR713,Niğde,344032.0,20845,5903,14942,14645,6200,134,7234
2015,TR714,Nevşehir,284417.0,21392,7099,14293,14090,7302,100,5485
2015,TR715,Kırşehir,222482.0,13514,4098,9416,9663,3851,31,6584
2015,TR721,Kayseri,1331537.0,101108,39020,62088,61552,39556,456,16970
2015,TR722,Sivas,615186.0,36804,12264,24540,25002,11802,122,28164
2015,TR723,Yozgat,413570.0,22398,6134,16264,15978,6420,111,13690
2015,TR811,Zonguldak,592888.0,33657,8583,25074,23061,10596,106,3342
2015,TR812,Karabük,233980.0,18213,4466,13747,13687,4526,93,4142
2015,TR813,Bartın,190043.0,12390,3133,9257,9066,3324,91,2330
2015,TR821,Kastamonu,366760.0,20985,6054,14931,14543,6442,54,13064
2015,TR822,Çankırı,178564.0,9985,2980,7005,6794,3191,53,7542
2015,TR823,Sinop,202654.0,11576,2095,9481,9286,2290,49,5717
2015,TR831,Samsun,1269430.0,98321,40825,57496,57536,40785,408,9725
2015,TR832,Tokat,591014.0,34211,10500,23711,24505,9706,95,10042
2015,TR833,Çorum,519324.0,29438,8820,20618,20764,8674,131,12428
2015,TR834,Amasya,320245.0,19278,5846,13432,13469,5809,90,5628
2015,TR901,Trabzon,764101.0,42600,16320,26280,26633,15967,213,4628
2015,TR902,Ordu,725291.0,39781,10647,29134,28158,11623,196,5914
2015,TR903,Giresun,424197.0,26361,7970,18391,18930,7431,119,6972
2015,TR904,Rize,327976.0,18249,5750,12499,12616,5633,173,3835
2015,TR905,Artvin,167915.0,10274,3220,7054,6493,3781,34,7393
2015,TR906,Gümüşhane,150178.0,6125,1475,4650,4484,1641,53,6668
2015,TRA11,Erzurum,759491.0,43464,16276,27188,26180,17284,269,25006
2015,TRA12,Erzincan,221514.0,15690,5161,10529,10224,5466,38,11815
2015,TRA13,Bayburt,78211.0,3952,1004,2948,3023,929,11,3746
2015,TRA21,Ağrı,546562.0,27659,11980,15679,15137,12522,156,11099
2015,TRA22,Kars,291610.0,14846,4586,10260,10267,4579,26,10193
2015,TRA23,Iğdır,191930.0,12952,4564,8388,8280,4672,69,3664
2015,TRA24,Ardahan,98952.0,6815,2146,4669,4511,2304,31,4934
2015,TRB11,Malatya,769036.0,51306,17988,33318,30419,20887,149,12259
2015,TRB12,Elazığ,573102.0,39163,14435,24728,23591,15572,283,9383
2015,TRB13,Bingöl,266725.0,14576,6106,8470,7910,6666,53,8003
2015,TRB14,Tunceli,85946.0,7184,2900,4284,3859,3325,27,7582
2015,TRB21,Van,1094303.0,55681,27165,28516,26566,29115,321,20921
2015,TRB22,Muş,408366.0,16623,6610,10013,9308,7315,81,8718
2015,TRB23,Bitlis,340334.0,16147,6144,10003,8674,7473,133,8294
2015,TRB24,Hakkari,278581.0,16239,8472,7767,7108,9131,61,7095
2015,TRC11,Gaziantep,1916252.0,168320,76912,91408,73557,94763,831,6803
2015,TRC12,Adıyaman,602292.0,26773,9691,17082,15745,11028,83,7337
2015,TRC13,Kilis,130076.0,16377,5985,10392,9274,7103,103,1412
2015,TRC21,Şanlıurfa,1889041.0,105651,45097,60554,49350,56301,602,19242
2015,TRC22,Diyarbakır,1653124.0,144677,83651,61026,49269,95408,457,15101
2015,TRC31,Mardin,794510.0,38477,14657,23820,21586,16891,382,8780
2015,TRC32,Batman,564975.0,44491,20276,24215,23257,21234,222,4477
2015,TRC33,Şırnak,489418.0,27122,12887,14235,11693,15429,111,7078
2015,TRC34,Siirt,319832.0,16645,7014,9631,8462,8183,65,5717
2014,TR100,İstanbul,14221482.0,1877707,1226072,651635,661539,1216168,6281,5461
2014,TR211,Tekirdağ,903940.0,75099,30042,45057,42028,33071,343,6190
2014,TR212,Edirne,397959.0,39447,15038,24409,23818,15629,200,6145
2014,TR213,Kırklareli,342661.0,23833,7613,16220,16253,7580,103,6459
2014,TR221,Balıkesir,1183579.0,96693,40190,56503,55378,41315,425,14583
2014,TR222,Çanakkale,509796.0,39206,14081,25125,23557,15649,307,9817
2014,TR310,İzmir,4091894.0,435465,237122,198343,203546,231919,1755,11891
2014,TR321,Aydın,1034333.0,114453,53162,61291,58098,56355,713,8116
2014,TR322,Denizli,973596.0,88862,42034,46828,42900,45962,204,12134
2014,TR323,Muğla,878566.0,101001,42116,58885,54764,46237,538,12654
2014,TR331,Manisa,1365242.0,115524,53931,61593,60969,54555,696,13339
2014,TR332,Afyonkarahisar,702712.0,44258,14660,29598,28066,16192,220,14016
2014,TR333,Kütahya,568221.0,31177,9382,21795,21289,9888,144,11634
2014,TR334,Uşak,345731.0,28847,11610,17237,16686,12161,119,5555
2014,TR411,Bursa,2763351.0,241488,110029,131459,124163,117325,667,10813
2014,TR412,Eskişehir,806323.0,93405,47785,45620,46394,47011,516,13960
2014,TR413,Bilecik,208439.0,16097,5284,10813,10722,5375,32,4179
2014,TR421,Kocaeli,1716566.0,149250,80650,68600,62862,86388,642,3397
2014,TR422,Sakarya,925541.0,67222,24584,42638,40066,27156,259,4824
2014,TR423,Düzce,353750.0,28528,9311,19217,18217,10311,236,2492
2014,TR424,Bolu,282258.0,21086,6691,14395,13714,7372,67,8313
2014,TR425,Yalova,222695.0,18191,7073,11118,11491,6700,154,798
2014,TR510,Ankara,5110993.0,584508,332631,251877,240072,344436,1294,25632
2014,TR521,Konya,2094919.0,155570,58361,97209,88112,67458,710,40838
2014,TR522,Karaman,239125.0,19645,5377,14268,14659,4986,69,8678
2014,TR611,Antalya,2174812.0,293085,145620,147465,138600,154485,1027,20177
2014,TR612,Isparta,415246.0,31643,9863,21780,20778,10865,127,8946
2014,TR613,Burdur,255388.0,18890,6335,12555,12225,6665,111,7175
2014,TR621,Adana,2154759.0,203390,101350,102040,93951,109439,943,13844
2014,TR622,Mersin,1715941.0,181235,91768,89467,84575,96660,530,16010
2014,TR631,Hatay,1515724.0,116428,48839,67589,60754,55674,879,5524
2014,TR632,Kahramanmaraş,1086037.0,59037,23925,35112,32324,26713,368,14520
2014,TR633,Osmaniye,506299.0,34333,10430,23903,22372,11961,187,3320
2014,TR711,Kırıkkale,268899.0,19321,6426,12895,12542,6779,114,4791
2014,TR712,Aksaray,378459.0,23743,8010,15733,13630,10113,60,7659
2014,TR713,Niğde,342738.0,20127,5870,14257,14224,5903,95,7234
2014,TR714,Nevşehir,283349.0,21017,6863,14154,13918,7099,145,5485
2014,TR715,Kırşehir,220841.0,13327,4167,9160,9229,4098,29,6584
2014,TR721,Kayseri,1314519.0,94949,37234,57715,55930,39019,361,16970
2014,TR722,Sivas,620214.0,37309,11909,25400,25045,12264,105,28164
2014,TR723,Yozgat,428141.0,21841,5676,16165,15707,6134,109,13690
2014,TR811,Zonguldak,596917.0,33212,8251,24961,24629,8583,174,3342
2014,TR812,Karabük,229751.0,17193,4814,12379,12727,4466,112,4142
2014,TR813,Bartın,188778.0,11211,2530,8681,8078,3133,103,2330
2014,TR821,Kastamonu,366004.0,19984,5788,14196,13934,6050,179,13064
2014,TR822,Çankırı,182378.0,10108,2828,7280,7128,2980,53,7542
2014,TR823,Sinop,203862.0,11109,2031,9078,9014,2095,65,5717
2014,TR831,Samsun,1264069.0,91499,39711,51788,50674,40825,354,9725
2014,TR832,Tokat,595692.0,32148,7957,24191,21648,10500,98,10042
2014,TR833,Çorum,523733.0,29317,9232,20085,20497,8820,101,12428
2014,TR834,Amasya,320828.0,18877,5086,13791,13031,5846,55,5628
2014,TR901,Trabzon,763654.0,40478,15405,25073,24158,16320,272,4628
2014,TR902,Ordu,722584.0,39849,10264,29585,29202,10647,204,5914
2014,TR903,Giresun,428051.0,26610,7931,18679,18640,7970,211,6972
2014,TR904,Rize,328927.0,18296,5185,13111,12546,5750,131,3835
2014,TR905,Artvin,169297.0,9865,2882,6983,6645,3220,39,7393
2014,TR906,Gümüşhane,145396.0,5874,1188,4686,4399,1475,14,6668
2014,TRA11,Erzurum,760703.0,42314,16177,26137,26038,16276,237,25006
2014,TRA12,Erzincan,222462.0,14481,4739,9742,9320,5161,80,11815
2014,TRA13,Bayburt,80301.0,3565,765,2800,2561,1004,10,3746
2014,TRA21,Ağrı,548705.0,25375,9353,16022,13395,11980,172,11099
2014,TRA22,Kars,295439.0,15317,4268,11049,10731,4586,15,10193
2014,TRA23,Iğdır,191606.0,12892,3575,9317,8328,4564,177,3664
2014,TRA24,Ardahan,100561.0,6941,1816,5125,4795,2146,33,4934
2014,TRB11,Malatya,766090.0,48497,18634,29863,30509,17988,167,12259
2014,TRB12,Elazığ,567997.0,38046,12428,25618,23612,14434,359,9383
2014,TRB13,Bingöl,265864.0,13856,3958,9898,7751,6105,73,8003
2014,TRB14,Tunceli,86405.0,7014,1645,5369,4114,2900,24,7582
2014,TRB21,Van,1083725.0,54735,26914,27821,27570,27165,465,20921
2014,TRB22,Muş,410853.0,14954,5042,9912,8344,6610,57,8718
2014,TRB23,Bitlis,337925.0,14263,4434,9829,8119,6144,89,8294
2014,TRB24,Hakkari,276109.0,16376,4918,11458,7904,8472,71,7095
2014,TRC11,Gaziantep,1878460.0,150946,70946,80000,74034,76912,805,6803
2014,TRC12,Adıyaman,597405.0,25779,8324,17455,16088,9691,120,7337
2014,TRC13,Kilis,127881.0,14953,4556,10397,8968,5985,68,1412
2014,TRC21,Şanlıurfa,1842316.0,96391,40839,55552,51294,45097,995,19242
2014,TRC22,Diyarbakır,1633958.0,143454,90233,53221,59803,83651,519,15101
2014,TRC31,Mardin,786257.0,34183,11080,23103,19526,14657,430,8780
2014,TRC32,Batman,555861.0,38041,16690,21351,17765,20276,133,4477
2014,TRC33,Şırnak,487906.0,25951,8267,17684,13064,12887,103,7078
2014,TRC34,Siirt,317877.0,15627,5287,10340,8613,7014,86,5717
2013,TR100,İstanbul,14025449.0,1818783,1168307,650476,594803,1223980,5713,5461
2013,TR211,Tekirdağ,871220.0,70722,28370,42352,40679,30043,368,6190
2013,TR212,Edirne,396572.0,36412,12513,23899,21374,15038,220,6145
2013,TR213,Kırklareli,339410.0,23594,7544,16050,15981,7613,130,6459
2013,TR221,Balıkesir,1158352.0,94599,38226,56373,54409,40190,546,14583
2013,TR222,Çanakkale,500588.0,36865,12559,24306,22784,14081,202,9817
2013,TR310,İzmir,4039477.0,445404,243551,201853,208908,236496,1557,11891
2013,TR321,Aydın,1012869.0,109658,48987,60671,56500,53158,789,8116
2013,TR322,Denizli,959944.0,85600,40652,44948,43578,42022,243,12134
2013,TR323,Muğla,850175.0,97030,37881,59149,54916,42114,592,12654
2013,TR331,Manisa,1357215.0,114331,52129,62202,60405,53926,583,13339
2013,TR332,Afyonkarahisar,703145.0,41482,13882,27600,26822,14660,169,14016
2013,TR333,Kütahya,570007.0,29486,8570,20916,20104,9382,162,11634
2013,TR334,Uşak,344070.0,28135,10457,17678,16525,11610,87,5555
2013,TR411,Bursa,2718379.0,223352,97445,125907,113399,109953,464,10813
2013,TR412,Eskişehir,794969.0,85440,42625,42815,37655,47785,392,13960
2013,TR413,Bilecik,207697.0,15784,5033,10751,10502,5282,39,4179
2013,TR421,Kocaeli,1669528.0,140462,73851,66611,59812,80650,753,3397
2013,TR422,Sakarya,911413.0,63825,23105,40720,39241,24584,358,4824
2013,TR423,Düzce,350091.0,29024,8560,20464,19713,9311,212,2492
2013,TR424,Bolu,282092.0,20948,6388,14560,14257,6691,74,8313
2013,TR425,Yalova,217130.0,17059,5959,11100,9986,7073,129,798
2013,TR510,Ankara,5013667.0,538761,304847,233914,206598,332163,1159,25632
2013,TR521,Konya,2068987.0,147928,52913,95015,89567,58361,664,40838
2013,TR522,Karaman,236925.0,17769,4595,13174,12392,5377,85,8678
2013,TR611,Antalya,2115955.0,286432,141708,144724,140910,145522,941,20177
2013,TR612,Isparta,415372.0,30316,9291,21025,20453,9863,95,8946
2013,TR613,Burdur,256097.0,18935,6523,12412,12600,6335,88,7175
2013,TR621,Adana,2138951.0,193630,93615,100015,93783,99847,1204,13844
2013,TR622,Mersin,1694370.0,180898,85425,95473,89130,91768,606,16010
2013,TR631,Hatay,1498306.0,102027,40284,61743,53189,48838,688,5524
2013,TR632,Kahramanmaraş,1072606.0,56754,22064,34690,32834,23920,362,14520
2013,TR633,Osmaniye,498388.0,34450,11057,23393,24020,10430,142,3320
2013,TR711,Kırıkkale,272969.0,19292,6581,12711,12866,6426,119,4791
2013,TR712,Aksaray,377690.0,22256,7785,14471,14246,8010,84,7659
2013,TR713,Niğde,342680.0,20428,5970,14458,14558,5870,82,7234
2013,TR714,Nevşehir,283658.0,20245,6338,13907,13383,6862,163,5485
2013,TR715,Kırşehir,221279.0,12818,3975,8843,8651,4167,49,6584
2013,TR721,Kayseri,1289141.0,92203,38164,54039,54969,37234,451,16970
2013,TR722,Sivas,621239.0,38358,12858,25500,26450,11908,133,28164
2013,TR723,Yozgat,439292.0,21239,5627,15612,15563,5676,89,13690
2013,TR811,Zonguldak,600431.0,33334,7452,25882,25083,8251,140,3342
2013,TR812,Karabük,229632.0,15911,4974,10937,11097,4814,118,4142
2013,TR813,Bartın,188683.0,11232,2545,8687,8702,2530,53,2330
2013,TR821,Kastamonu,366264.0,18488,4710,13778,12700,5788,133,13064
2013,TR822,Çankırı,190298.0,10074,2819,7255,7246,2828,91,7542
2013,TR823,Sinop,204144.0,11351,2109,9242,9320,2031,52,5717
2013,TR831,Samsun,1257053.0,90421,39588,50833,50847,39574,381,9725
2013,TR832,Tokat,596078.0,29361,7756,21605,21404,7957,98,10042
2013,TR833,Çorum,529091.0,29254,9741,19513,20022,9232,138,12428
2013,TR834,Amasya,320595.0,18911,4797,14114,13825,5086,68,5628
2013,TR901,Trabzon,755906.0,39660,14676,24984,24255,15405,216,4628
2013,TR902,Ordu,730061.0,40356,9927,30429,30092,10264,281,5914
2013,TR903,Giresun,423525.0,26443,7945,18498,18512,7931,273,6972
2013,TR904,Rize,327459.0,16879,4920,11959,11695,5184,93,3835
2013,TR905,Artvin,169004.0,9488,2514,6974,6608,2880,55,7393
2013,TR906,Gümüşhane,140548.0,6067,1045,5022,4879,1188,20,6668
2013,TRA11,Erzurum,764211.0,40156,14846,25310,25265,14891,286,25006
2013,TRA12,Erzincan,218978.0,14326,4679,9647,9589,4737,121,11815
2013,TRA13,Bayburt,75364.0,3220,739,2481,2455,765,17,3746
2013,TRA21,Ağrı,550511.0,21405,8086,13319,12064,9341,147,11099
2013,TRA22,Kars,300119.0,14288,3533,10755,10055,4233,29,10193
2013,TRA23,Iğdır,189964.0,11763,2879,8884,8198,3565,117,3664
2013,TRA24,Ardahan,102587.0,7018,1443,5575,5215,1803,17,4934
2013,TRB11,Malatya,759818.0,47420,18303,29117,30406,17014,219,12259
2013,TRB12,Elazığ,567631.0,32991,10521,22470,20571,12420,450,9383
2013,TRB13,Bingöl,265365.0,11494,3515,7979,7536,3958,27,8003
2013,TRB14,Tunceli,85329.0,5279,1685,3594,3656,1623,28,7582
2013,TRB21,Van,1069109.0,46297,20435,25862,23857,22440,322,20921
2013,TRB22,Muş,412219.0,14176,4333,9843,9134,5042,37,8718
2013,TRB23,Bitlis,337053.0,12054,3753,8301,7627,4427,63,8294
2013,TRB24,Hakkari,272901.0,11605,4544,7061,6688,4917,70,7095
2013,TRC11,Gaziantep,1835709.0,148455,64988,83467,77509,70946,688,6803
2013,TRC12,Adıyaman,596728.0,24558,7667,16891,16244,8314,114,7337
2013,TRC13,Kilis,127106.0,13198,3908,9290,8642,4556,77,1412
2013,TRC21,Şanlıurfa,1797738.0,89661,32944,56717,48822,40839,729,19242
2013,TRC22,Diyarbakır,1606510.0,125019,75824,49195,46540,78479,413,15101
2013,TRC31,Mardin,776671.0,30734,9354,21380,19654,11080,358,8780
2013,TRC32,Batman,545709.0,30717,11852,18865,14027,16690,97,4477
2013,TRC33,Şırnak,474204.0,20790,6660,14130,12523,8267,73,7078
2013,TRC34,Siirt,313688.0,13385,4960,8425,8098,5287,55,5717
2012,TR100,İstanbul,13769380.0,1746437,1097667,648770,578135,1168302,5575,5461
2012,TR211,Tekirdağ,850002.0,64769,23426,41343,36401,28368,212,6190
2012,TR212,Edirne,398124.0,33784,10360,23424,21271,12513,250,6145
2012,TR213,Kırklareli,340332.0,21997,6558,15439,14453,7544,107,6459
2012,TR221,Balıkesir,1158268.0,87517,33046,54471,49291,38226,492,14583
2012,TR222,Çanakkale,492587.0,36054,11888,24166,23495,12559,286,9817
2012,TR310,İzmir,3992476.0,425927,227514,198413,182376,243551,1542,11891
2012,TR321,Aydın,1002412.0,100918,42573,58345,51931,48987,924,8116
2012,TR322,Denizli,948344.0,87828,41921,45907,47176,40652,259,12134
2012,TR323,Muğla,840936.0,86313,32309,54004,48432,37881,529,12654
2012,TR331,Manisa,1345125.0,108296,46171,62125,56167,52129,645,13339
2012,TR332,Afyonkarahisar,701152.0,39718,12432,27286,25836,13882,200,14016
2012,TR333,Kütahya,572126.0,28931,8287,20644,20361,8570,179,11634
2012,TR334,Uşak,341143.0,26960,9248,17712,16503,10457,64,5555
2012,TR411,Bursa,2674365.0,207197,86689,120508,109755,97442,470,10813
2012,TR412,Eskişehir,786977.0,76395,38020,38375,33770,42625,339,13960
2012,TR413,Bilecik,203461.0,14811,4476,10335,9778,5033,70,4179
2012,TR421,Kocaeli,1630553.0,130638,64364,66274,56787,73851,528,3397
2012,TR422,Sakarya,898915.0,58278,19162,39116,35173,23105,284,4824
2012,TR423,Düzce,345722.0,28294,8141,20153,19734,8560,180,2492
2012,TR424,Bolu,280259.0,19763,5486,14277,13376,6387,96,8313
2012,TR425,Yalova,209992.0,14972,5276,9696,9013,5959,178,798
2012,TR510,Ankara,4943343.0,495057,279375,215682,190210,304847,1206,25632
2012,TR521,Konya,2047993.0,134654,41584,93070,81741,52913,704,40838
2012,TR522,Karaman,234932.0,15862,4167,11695,11267,4595,126,8678
2012,TR611,Antalya,2065052.0,264144,127175,136969,122437,141707,866,20177
2012,TR612,Isparta,414857.0,29402,8174,21228,20117,9285,90,8946
2012,TR613,Burdur,253645.0,18228,5997,12231,11705,6523,85,7175
2012,TR621,Adana,2120894.0,179927,87152,92775,86311,93616,724,13844
2012,TR622,Mersin,1679274.0,163318,75697,87621,77893,85425,662,16010
2012,TR631,Hatay,1480654.0,87082,33745,53337,46798,40284,517,5524
2012,TR632,Kahramanmaraş,1061648.0,53408,20646,32762,31344,22064,294,14520
2012,TR633,Osmaniye,491902.0,30692,9484,21208,19635,11057,107,3320
2012,TR711,Kırıkkale,273540.0,18112,5954,12158,11531,6581,119,4791
2012,TR712,Aksaray,376298.0,18672,6139,12533,10887,7785,101,7659
2012,TR713,Niğde,339574.0,20523,6051,14472,14553,5970,83,7234
2012,TR714,Nevşehir,283655.0,20661,5950,14711,14323,6338,207,5485
2012,TR715,Kırşehir,219977.0,12445,4188,8257,8470,3975,92,6584
2012,TR721,Kayseri,1270806.0,85880,33779,52101,47718,38162,462,16970
2012,TR722,Sivas,621652.0,37819,12646,25173,24961,12858,106,28164
2012,TR723,Yozgat,449278.0,21434,5223,16211,15807,5627,108,13690
2012,TR811,Zonguldak,606109.0,32190,7317,24873,24738,7452,138,3342
2012,TR812,Karabük,225029.0,14543,3920,10623,9569,4974,39,4142
2012,TR813,Bartın,188123.0,10772,2724,8048,8227,2545,63,2330
2012,TR821,Kastamonu,358439.0,17408,4318,13090,12694,4714,180,13064
2012,TR822,Çankırı,184073.0,10129,2844,7285,7310,2819,129,7542
2012,TR823,Sinop,201203.0,11611,2134,9477,9502,2109,78,5717
2012,TR831,Samsun,1249227.0,87925,34841,53084,48340,39585,333,9725
2012,TR832,Tokat,612224.0,28451,7326,21125,20695,7756,95,10042
2012,TR833,Çorum,528242.0,28295,9911,18384,18554,9741,175,12428
2012,TR834,Amasya,320917.0,17585,4529,13056,12788,4797,78,5628
2012,TR901,Trabzon,756406.0,39614,13214,26400,24937,14677,161,4628
2012,TR902,Ordu,740480.0,38992,9124,29868,29066,9926,335,5914
2012,TR903,Giresun,418980.0,24374,7316,17058,16428,7946,271,6972
2012,TR904,Rize,323565.0,16999,5210,11789,12079,4920,70,3835
2012,TR905,Artvin,166846.0,8626,2418,6208,6113,2513,54,7393
2012,TR906,Gümüşhane,134513.0,6239,974,5265,5194,1045,29,6668
2012,TRA11,Erzurum,776588.0,39592,13876,25716,24746,14846,217,25006
2012,TRA12,Erzincan,217371.0,13769,4454,9315,9090,4679,79,11815
2012,TRA13,Bayburt,75635.0,3296,829,2467,2557,739,25,3746
2012,TRA21,Ağrı,551745.0,20452,7660,12792,12366,8086,100,11099
2012,TRA22,Kars,304299.0,13944,3075,10869,10411,3533,58,10193
2012,TRA23,Iğdır,190056.0,11229,3129,8100,8350,2879,111,3664
2012,TRA24,Ardahan,106522.0,6260,1177,5083,4817,1443,33,4934
2012,TRB11,Malatya,760508.0,46477,15620,30857,28174,18303,251,12259
2012,TRB12,Elazığ,562439.0,30597,8877,21720,20075,10522,380,9383
2012,TRB13,Bingöl,262434.0,10164,3218,6946,6649,3515,37,8003
2012,TRB14,Tunceli,86244.0,5331,1570,3761,3646,1685,40,7582
2012,TRB21,Van,1051387.0,41069,18856,22213,20636,20433,243,20921
2012,TRB22,Muş,413014.0,12052,3581,8471,7719,4333,60,8718
2012,TRB23,Bitlis,337199.0,11872,3545,8327,8119,3753,86,8294
2012,TRB24,Hakkari,279868.0,10633,3773,6860,6089,4544,29,7095
2012,TRC11,Gaziantep,1795430.0,137831,55111,82720,72844,64987,564,6803
2012,TRC12,Adıyaman,595030.0,24581,7264,17317,16914,7667,142,7337
2012,TRC13,Kilis,123965.0,9401,2383,7018,5493,3908,73,1412
2012,TRC21,Şanlıurfa,1760307.0,82350,27122,55228,49406,32944,470,19242
2012,TRC22,Diyarbakır,1591658.0,118633,71144,47489,42809,75824,353,15101
2012,TRC31,Mardin,771024.0,31790,10497,21293,22436,9354,220,8780
2012,TRC32,Batman,533194.0,25505,10564,14941,13653,11852,124,4477
2012,TRC33,Şırnak,466206.0,18551,5624,12927,11891,6660,41,7078
2012,TRC34,Siirt,310596.0,12853,4728,8125,7893,4960,58,5717
2011,TR100,İstanbul,13552531.0,1709431,1045616,663815,611733,1097698,4920,5461
2011,TR211,Tekirdağ,827602.0,58755,21173,37582,35329,23426,154,6190
2011,TR212,Edirne,398034.0,29731,9213,20518,19371,10360,223,6145
2011,TR213,Kırklareli,339470.0,21058,6830,14228,14500,6558,152,6459
2011,TR221,Balıkesir,1152216.0,84533,32269,52264,51487,33046,521,14583
2011,TR222,Çanakkale,485200.0,32534,10537,21997,20646,11888,183,9817
2011,TR310,İzmir,3951759.0,415053,228594,186459,187576,227477,1427,11891
2011,TR321,Aydın,993787.0,97266,39349,57917,54693,42573,950,8116
2011,TR322,Denizli,940883.0,88806,41012,47794,46885,41921,285,12134
2011,TR323,Muğla,828664.0,80241,29464,50777,47932,32309,522,12654
2011,TR331,Manisa,1339046.0,101563,43435,58128,55392,46171,627,13339
2011,TR332,Afyonkarahisar,696804.0,40014,12086,27928,27582,12432,202,14016
2011,TR333,Kütahya,563328.0,28349,7481,20868,20063,8286,119,11634
2011,TR334,Uşak,339156.0,26033,8320,17713,16785,9248,158,5555
2011,TR411,Bursa,2639708.0,198551,80103,118448,111862,86689,632,10813
2011,TR412,Eskişehir,778576.0,70895,33614,37281,32875,38020,292,13960
2011,TR413,Bilecik,203409.0,15244,4968,10276,10768,4476,95,4179
2011,TR421,Kocaeli,1598174.0,123117,57380,65737,58753,64364,691,3397
2011,TR422,Sakarya,886560.0,51848,15313,36535,32687,19161,295,4824
2011,TR423,Düzce,341826.0,27236,8434,18802,19094,8142,198,2492
2011,TR424,Bolu,275889.0,18560,5026,13534,13074,5486,90,8313
2011,TR425,Yalova,205304.0,13372,4851,8521,8096,5276,131,798
2011,TR510,Ankara,4871354.0,460601,250471,210130,181228,279373,1202,25632
2011,TR521,Konya,2033330.0,120422,31986,88436,78840,41582,751,40838
2011,TR522,Karaman,233624.0,15025,3911,11114,10858,4167,141,8678
2011,TR611,Antalya,2016910.0,253481,117211,136270,126306,127175,853,20177
2011,TR612,Isparta,410153.0,28109,7321,20788,19935,8174,77,8946
2011,TR613,Burdur,250192.0,19224,6209,13015,13227,5997,125,7175
2011,TR621,Adana,2104936.0,171394,82061,89333,84244,87150,558,13844
2011,TR622,Mersin,1664997.0,150456,66028,84428,74759,75697,629,16010
2011,TR631,Hatay,1471084.0,78874,29799,49075,45129,33745,555,5524
2011,TR632,Kahramanmaraş,1053199.0,49786,18806,30980,29140,20646,286,14520
2011,TR633,Osmaniye,485173.0,28209,9458,18751,18725,9484,185,3320
2011,TR711,Kırıkkale,274250.0,18833,5679,13154,12879,5954,73,4791
2011,TR712,Aksaray,375351.0,16777,5160,11617,10638,6139,159,7659
2011,TR713,Niğde,337264.0,18660,4857,13803,12608,6052,115,7234
2011,TR714,Nevşehir,281904.0,18077,5126,12951,12127,5950,81,5485
2011,TR715,Kırşehir,220448.0,11757,3749,8008,7426,4331,147,6584
2011,TR721,Kayseri,1252080.0,78362,30417,47945,44583,33779,635,16970
2011,TR722,Sivas,625438.0,40575,13962,26613,27929,12646,177,28164
2011,TR723,Yozgat,461932.0,19807,4965,14842,14727,5080,154,13690
2011,TR811,Zonguldak,611659.0,32965,7579,25386,25648,7317,192,3342
2011,TR812,Karabük,219618.0,12980,2697,10283,9060,3920,38,4142
2011,TR813,Bartın,187092.0,11104,2169,8935,8380,2724,82,2330
2011,TR821,Kastamonu,359163.0,18439,5163,13276,14059,4380,274,13064
2011,TR822,Çankırı,176951.0,10339,2798,7541,7495,2844,106,7542
2011,TR823,Sinop,202899.0,10444,1787,8657,8372,2072,102,5717
2011,TR831,Samsun,1249500.0,84218,32817,51401,49377,34841,453,9725
2011,TR832,Tokat,606820.0,28087,7175,20912,20761,7326,190,10042
2011,TR833,Çorum,532985.0,28252,9234,19018,18341,9911,378,12428
2011,TR834,Amasya,322487.0,17495,4775,12720,12966,4529,70,5628
2011,TR901,Trabzon,755890.0,39338,13890,25448,26124,13214,213,4628
2011,TR902,Ordu,713578.0,38486,9039,29447,29362,9124,365,5914
2011,TR903,Giresun,418745.0,24215,7225,16990,16899,7316,290,6972
2011,TR904,Rize,322739.0,18663,6115,12548,13453,5210,86,3835
2011,TR905,Artvin,166228.0,9196,2784,6412,6778,2418,76,7393
2011,TR906,Gümüşhane,131722.0,6220,981,5239,5246,974,16,6668
2011,TRA11,Erzurum,779177.0,41703,15637,26066,27827,13876,343,25006
2011,TRA12,Erzincan,215106.0,14453,5217,9236,9999,4454,120,11815
2011,TRA13,Bayburt,76697.0,2948,631,2317,2119,829,20,3746
2011,TRA21,Ağrı,555094.0,23537,7780,15757,15877,7660,276,11099
2011,TRA22,Kars,305684.0,14862,3992,10870,11787,3075,107,10193
2011,TRA23,Iğdır,188520.0,10696,2330,8366,7567,3129,238,3664
2011,TRA24,Ardahan,107396.0,7382,1653,5729,6205,1177,130,4934
2011,TRB11,Malatya,757215.0,43786,13912,29874,28166,15620,255,12259
2011,TRB12,Elazığ,558231.0,30259,8636,21623,21382,8877,333,9383
2011,TRB13,Bingöl,262150.0,8621,2005,6616,5403,3218,39,8003
2011,TRB14,Tunceli,85000.0,5775,1614,4161,4205,1570,42,7582
2011,TRB21,Van,1021894.0,36682,13699,22983,17827,18855,194,20921
2011,TRB22,Muş,414404.0,12288,3158,9130,8707,3581,35,8718
2011,TRB23,Bitlis,336522.0,13608,3370,10238,10063,3545,239,8294
2011,TRB24,Hakkari,272095.0,9562,3131,6431,5789,3773,23,7095
2011,TRC11,Gaziantep,1750491.0,119006,54566,64440,63895,55111,446,6803
2011,TRC12,Adıyaman,593707.0,22908,5746,17162,15644,7264,193,7337
2011,TRC13,Kilis,124254.0,6992,2191,4801,4609,2383,42,1412
2011,TRC21,Şanlıurfa,1714518.0,75301,22363,52938,48179,27122,595,19242
2011,TRC22,Diyarbakır,1570484.0,107963,56767,51196,36819,71144,397,15101
2011,TRC31,Mardin,762055.0,30844,10055,20789,20347,10497,181,8780
2011,TRC32,Batman,524155.0,25292,10051,15241,14728,10564,225,4477
2011,TRC33,Şırnak,457260.0,18009,5212,12797,12385,5624,32,7078
2011,TRC34,Siirt,310411.0,12122,3986,8136,7394,4728,40,5717
2010,TR100,İstanbul,13202784.0,1811645,1113247,698398,766025,1045620,5896,5461
2010,TR211,Tekirdağ,795983.0,53500,19902,33598,32327,21173,171,6190
2010,TR212,Edirne,389714.0,29637,9165,20472,20424,9213,233,6145
2010,TR213,Kırklareli,332217.0,20639,7134,13505,13810,6829,116,6459
2010,TR221,Balıkesir,1150470.0,82811,30772,52039,50542,32269,426,14583
2010,TR222,Çanakkale,489409.0,31681,9583,22098,21144,10537,152,9817
2010,TR310,İzmir,3937428.0,449338,253800,195538,220610,228728,1557,11891
2010,TR321,Aydın,986200.0,89202,34908,54294,49855,39347,974,8116
2010,TR322,Denizli,930155.0,85968,39969,45999,44956,41012,343,12134
2010,TR323,Muğla,810164.0,76309,25706,50603,46844,29465,527,12654
2010,TR331,Manisa,1378658.0,97495,41556,55939,54059,43436,642,13339
2010,TR332,Afyonkarahisar,695986.0,40069,11842,28227,27983,12086,294,14016
2010,TR333,Kütahya,589912.0,28217,7287,20930,20736,7481,129,11634
2010,TR334,Uşak,337502.0,24636,8236,16400,16316,8320,52,5555
2010,TR411,Bursa,2590792.0,188733,76127,112606,108630,80103,651,10813
2010,TR412,Eskişehir,762679.0,68799,31746,37053,35185,33614,369,13960
2010,TR413,Bilecik,225099.0,14766,4421,10345,9798,4968,111,4179
2010,TR421,Kocaeli,1556025.0,113951,53263,60688,56571,57380,955,3397
2010,TR422,Sakarya,871244.0,47719,15318,32401,32406,15313,216,4824
2010,TR423,Düzce,337857.0,25560,7771,17789,17126,8434,257,2492
2010,TR424,Bolu,270986.0,18334,4822,13512,13308,5026,163,8313
2010,TR425,Yalova,203058.0,12926,4212,8714,8075,4851,92,798
2010,TR510,Ankara,4756952.0,433592,220453,213139,183121,250471,912,25632
2010,TR521,Konya,2009371.0,112705,29412,83293,80720,31985,963,40838
2010,TR522,Karaman,232228.0,14031,3866,10165,10120,3911,134,8678
2010,TR611,Antalya,1959686.0,248279,115500,132779,131070,117209,799,20177
2010,TR612,Isparta,447595.0,26708,6699,20009,19387,7321,109,8946
2010,TR613,Burdur,258633.0,19037,5741,13296,12828,6209,206,7175
2010,TR621,Adana,2082627.0,168294,80969,87325,86232,82062,504,13844
2010,TR622,Mersin,1644948.0,140192,56511,83681,74164,66028,516,16010
2010,TR631,Hatay,1477676.0,77958,28370,49588,48160,29798,524,5524
2010,TR632,Kahramanmaraş,1043665.0,52588,17367,35221,33782,18806,339,14520
2010,TR633,Osmaniye,479111.0,29477,9376,20101,20019,9458,182,3320
2010,TR711,Kırıkkale,276414.0,17760,5049,12711,12081,5679,67,4791
2010,TR712,Aksaray,373861.0,17065,5268,11797,11905,5160,184,7659
2010,TR713,Niğde,337782.0,18121,4401,13720,13264,4857,101,7234
2010,TR714,Nevşehir,281347.0,17942,5000,12942,12816,5126,61,5485
2010,TR715,Kırşehir,221363.0,12196,3388,8808,8447,3749,256,6584
2010,TR721,Kayseri,1232759.0,80642,30180,50462,50225,30417,846,16970
2010,TR722,Sivas,641129.0,43534,12523,31011,29572,13962,135,28164
2010,TR723,Yozgat,472170.0,19561,4508,15053,14596,4965,211,13690
2010,TR811,Zonguldak,618939.0,32870,7689,25181,25291,7579,348,3342
2010,TR812,Karabük,227533.0,13430,2980,10450,10733,2697,67,4142
2010,TR813,Bartın,187494.0,11810,2378,9432,9641,2169,81,2330
2010,TR821,Kastamonu,361083.0,20829,5297,15532,15666,5163,333,13064
2010,TR822,Çankırı,178908.0,10495,2899,7596,7697,2798,41,7542
2010,TR823,Sinop,202617.0,11564,2039,9525,9777,1787,63,5717
2010,TR831,Samsun,1251185.0,81805,30035,51770,48988,32817,590,9725
2010,TR832,Tokat,616313.0,31432,7064,24368,24257,7175,141,10042
2010,TR833,Çorum,534454.0,30284,9319,20965,21051,9233,665,12428
2010,TR834,Amasya,334512.0,18125,4395,13730,13350,4775,61,5628
2010,TR901,Trabzon,762517.0,40701,13136,27565,26812,13889,218,4628
2010,TR902,Ordu,718436.0,39453,9686,29767,30414,9039,352,5914
2010,TR903,Giresun,418417.0,25102,7535,17567,17877,7225,412,6972
2010,TR904,Rize,319437.0,19200,5205,13995,13084,6116,95,3835
2010,TR905,Artvin,164646.0,9685,2483,7202,6901,2784,65,7393
2010,TR906,Gümüşhane,128809.0,5894,1026,4868,4913,981,21,6668
2010,TRA11,Erzurum,768348.0,46238,16211,30027,30601,15637,364,25006
2010,TRA12,Erzincan,224804.0,14888,4330,10558,9671,5217,129,11815
2010,TRA13,Bayburt,74400.0,3279,629,2650,2648,631,7,3746
2010,TRA21,Ağrı,541825.0,25243,6516,18727,17463,7780,335,11099
2010,TRA22,Kars,301711.0,16607,2693,13914,12615,3992,180,10193
2010,TRA23,Iğdır,184133.0,11250,1870,9380,8920,2330,36,3664
2010,TRA24,Ardahan,105440.0,8333,1257,7076,6680,1653,154,4934
2010,TRB11,Malatya,740085.0,43116,12083,31033,29204,13912,252,12259
2010,TRB12,Elazığ,552380.0,32375,8760,23615,23739,8636,294,9383
2010,TRB13,Bingöl,255064.0,8874,1986,6888,6869,2005,13,8003
2010,TRB14,Tunceli,76654.0,6365,1482,4883,4751,1614,55,7582
2010,TRB21,Van,1035077.0,44707,15626,29081,31009,13698,545,20921
2010,TRB22,Muş,406552.0,15642,2963,12679,12497,3145,75,8718
2010,TRB23,Bitlis,328732.0,15480,3015,12465,12110,3370,176,8294
2010,TRB24,Hakkari,251256.0,10508,2616,7892,7377,3131,95,7095
2010,TRC11,Gaziantep,1699378.0,118665,51514,67151,64101,54564,598,6803
2010,TRC12,Adıyaman,590698.0,21582,4827,16755,15836,5746,90,7337
2010,TRC13,Kilis,123102.0,7244,2124,5120,5053,2191,64,1412
2010,TRC21,Şanlıurfa,1661854.0,75908,18135,57773,53545,22363,716,19242
2010,TRC22,Diyarbakır,1528708.0,100012,50247,49765,43245,56767,334,15101
2010,TRC31,Mardin,742994.0,30543,8998,21545,20488,10055,345,8780
2010,TRC32,Batman,510034.0,25104,8406,16698,15052,10052,253,4477
2010,TRC33,Şırnak,429616.0,17405,3908,13497,12193,5212,126,7078
2010,TRC34,Siirt,300673.0,13012,3680,9332,9026,3986,35,5717
2009,TR100,İstanbul,12867332.0,1914490,1135232,779258,801245,1113245,8145,5461
2009,TR211,Tekirdağ,781508.0,51705,18798,32907,31803,19902,393,6190
2009,TR212,Edirne,394762.0,29164,8479,20685,19999,9165,236,6145
2009,TR213,Kırklareli,332745.0,19878,6564,13314,12744,7134,167,6459
2009,TR221,Balıkesir,1138553.0,81502,32052,49450,50730,30772,512,14583
2009,TR222,Çanakkale,476742.0,29828,8871,20957,20245,9583,187,9817
2009,TR310,İzmir,3858315.0,472982,277839,195143,219183,253799,2260,11891
2009,TR321,Aydın,975750.0,85946,33929,52017,51038,34908,1130,8116
2009,TR322,Denizli,924987.0,82808,37273,45535,42839,39969,527,12134
2009,TR323,Muğla,796322.0,78158,27052,51106,52454,25704,665,12654
2009,TR331,Manisa,1331344.0,94359,38973,55386,52803,41556,749,13339
2009,TR332,Afyonkarahisar,700054.0,37909,10641,27268,26067,11842,310,14016
2009,TR333,Kütahya,571342.0,27798,7652,20146,20511,7287,148,11634
2009,TR334,Uşak,335519.0,25238,8322,16916,17002,8236,110,5555
2009,TR411,Bursa,2535923.0,182866,71656,111210,106739,76127,1219,10813
2009,TR412,Eskişehir,753859.0,65824,32269,33555,34078,31746,392,13960
2009,TR413,Bilecik,201773.0,13203,3887,9316,8782,4421,124,4179
2009,TR421,Kocaeli,1518640.0,105712,47201,58511,52448,53264,907,3397
2009,TR422,Sakarya,860367.0,44420,14730,29690,29102,15318,339,4824
2009,TR423,Düzce,334921.0,22894,6847,16047,15122,7772,351,2492
2009,TR424,Bolu,271363.0,18160,4935,13225,13338,4822,54,8313
2009,TR425,Yalova,202001.0,12511,3341,9170,8299,4212,155,798
2009,TR510,Ankara,4637155.0,433137,200693,232444,212684,220453,1384,25632
2009,TR521,Konya,1989934.0,109258,28524,80734,79846,29412,839,40838
2009,TR522,Karaman,231539.0,12657,3996,8661,8791,3866,105,8678
2009,TR611,Antalya,1902640.0,259275,122436,136839,143775,115500,879,20177
2009,TR612,Isparta,420242.0,22617,5326,17291,15918,6699,92,8946
2009,TR613,Burdur,251358.0,18084,5558,12526,12343,5741,73,7175
2009,TR621,Adana,2059810.0,167184,79072,88112,86216,80968,802,13844
2009,TR622,Mersin,1638098.0,129612,50957,78655,73101,56511,870,16010
2009,TR631,Hatay,1445651.0,65434,23442,41992,37061,28373,716,5524
2009,TR632,Kahramanmaraş,1036588.0,51227,16375,34852,33860,17367,414,14520
2009,TR633,Osmaniye,471722.0,26268,9764,16504,16892,9376,280,3320
2009,TR711,Kırıkkale,280641.0,18409,5227,13182,13360,5049,101,4791
2009,TR712,Aksaray,374057.0,17007,6279,10728,11739,5268,176,7659
2009,TR713,Niğde,339803.0,16483,4266,12217,12082,4401,103,7234
2009,TR714,Nevşehir,283220.0,16758,4758,12000,11758,5000,81,5485
2009,TR715,Kırşehir,222697.0,12364,3499,8865,8976,3388,196,6584
2009,TR721,Kayseri,1204236.0,77592,25440,52152,47412,30180,1483,16970
2009,TR722,Sivas,632542.0,39193,11706,27487,26670,12523,135,28164
2009,TR723,Yozgat,484290.0,18948,4143,14805,14440,4508,172,13690
2009,TR811,Zonguldak,619220.0,31093,7470,23623,23404,7689,391,3342
2009,TR812,Karabük,218500.0,12506,2502,10004,9526,2980,61,4142
2009,TR813,Bartın,188196.0,10354,2344,8010,7976,2378,75,2330
2009,TR821,Kastamonu,359705.0,20532,5903,14629,15235,5297,280,13064
2009,TR822,Çankırı,184900.0,9523,2430,7093,6624,2899,47,7542
2009,TR823,Sinop,201043.0,10718,2716,8002,8679,2039,113,5717
2009,TR831,Samsun,1249026.0,82936,28928,54008,52900,30036,795,9725
2009,TR832,Tokat,623351.0,28781,7151,21630,21716,7065,250,10042
2009,TR833,Çorum,539970.0,28776,9000,19776,19460,9316,647,12428
2009,TR834,Amasya,324003.0,15354,3873,11481,10959,4395,89,5628
2009,TR901,Trabzon,764099.0,39143,13233,25910,26007,13136,412,4628
2009,TR902,Ordu,722958.0,35426,8632,26794,25740,9686,229,5914
2009,TR903,Giresun,421256.0,23518,7030,16488,15983,7535,176,6972
2009,TR904,Rize,319380.0,18282,4652,13630,13077,5205,99,3835
2009,TR905,Artvin,165456.0,8338,2296,6042,5855,2483,98,7393
2009,TR906,Gümüşhane,130362.0,6026,1272,4754,5000,1026,54,6668
2009,TRA11,Erzurum,773619.0,44805,16872,27933,28594,16211,438,25006
2009,TRA12,Erzincan,213193.0,12865,3045,9820,8535,4330,96,11815
2009,TRA13,Bayburt,74701.0,3092,664,2428,2463,629,17,3746
2009,TRA21,Ağrı,537464.0,21047,6751,14296,14531,6516,462,11099
2009,TRA22,Kars,306491.0,13640,2257,11383,10947,2693,124,10193
2009,TRA23,Iğdır,183231.0,9809,1798,8011,7938,1871,107,3664
2009,TRA24,Ardahan,108152.0,6451,1251,5200,5194,1257,76,4934
2009,TRB11,Malatya,736474.0,39208,12020,27188,27125,12083,339,12259
2009,TRB12,Elazığ,550468.0,29413,7485,21928,20653,8760,349,9383
2009,TRB13,Bingöl,255662.0,8645,1908,6737,6659,1986,24,8003
2009,TRB14,Tunceli,83033.0,5339,1198,4141,3857,1482,27,7582
2009,TRB21,Van,1022083.0,42527,16812,25715,26901,15626,748,20921
2009,TRB22,Muş,404249.0,13558,2897,10661,10595,2963,112,8718
2009,TRB23,Bitlis,328460.0,12181,2791,9390,9166,3015,191,8294
2009,TRB24,Hakkari,256719.0,8705,2502,6203,6089,2616,81,7095
2009,TRC11,Gaziantep,1652614.0,117121,51687,65434,65607,51514,886,6803
2009,TRC12,Adıyaman,588315.0,21002,5243,15759,16175,4827,151,7337
2009,TRC13,Kilis,122061.0,5959,1608,4351,3835,2124,86,1412
2009,TRC21,Şanlıurfa,1612515.0,63734,15434,48300,45599,18135,1188,19242
2009,TRC22,Diyarbakır,1514793.0,89211,47222,41989,38964,50247,602,15101
2009,TRC31,Mardin,736455.0,24841,7067,17774,15843,8998,390,8780
2009,TRC32,Batman,497841.0,22390,8826,13564,13984,8406,189,4477
2009,TRC33,Şırnak,430006.0,13615,3692,9923,9707,3908,47,7078
2009,TRC34,Siirt,303599.0,11344,3482,7862,7664,3680,59,5717
